{
    "playerX": 4,
    "playerY": 25,
    "map":
      [[1, 1, 1, 1, 1, 1, 1, 1, 1, 1, 1, 1, 1, 1, 1, 1, 1, 1, 1],
       [1, 1, 1, 1, 1, 1, 1, 1, 1, 1, 1, 1, 1, 1, 1, 1, 1, 1, 1],
       [1, 1, 1, 1, 0, 0, 1, 0, 1, 0, 1, 0, 1, 0, 0, 0, 1, 1, 1],
       [1, 1, 1, 1, 0, 0, 0, 0, 0, 0, 0, 0, 0, 0, 0, 0, 1, 1, 1],
       [1, 1, 1, 1, 0, 0, 1, 0, 1, 0, 1, 0, 1, 0, 0, 0, 1, 1, 1],
       [1, 1, 1, 1, 0, 0, 1, 1, 1, 1, 1, 1, 1, 0, 5, 0, 1, 1, 1],
       [1, 1, 1, 1, 0, 0, 1, 1, 1, 1, 1, 1, 1, 0, 5, 0, 1, 1, 1],
       [1, 1, 1, 1, 0, 0, 1, 1, 1, 1, 1, 1, 1, 0, 5, 0, 1, 1, 1],
       [1, 1, 0, 0, 0, 0, 0, 0, 1, 1, 1, 1, 1, 0, 5, 0, 1, 1, 1],
       [1, 1, 0, 0, 0, 0, 0, 0, 1, 1, 1, 1, 1, 0, 5, 0, 1, 1, 1],
       [1, 1, 0, 0, 0, 0, 0, 0, 1, 1, 1, 1, 1, 0, 5, 0, 1, 1, 1],
       [1, 1, 0, 0, 0, 1, 1, 1, 1, 1, 1, 1, 1, 0, 5, 0, 1, 1, 1],
       [1, 1, 0, 0, 0, 1, 1, 1, 1, 1, 1, 1, 1, 0, 5, 0, 1, 1, 1],
       [1, 1, 0, 0, 0, 0, 0, 0, 1, 1, 1, 1, 1, 0, 5, 0, 1, 1, 1],
       [1, 1, 0, 0, 0, 0, 0, 0, 1, 1, 1, 1, 1, 0, 5, 0, 1, 1, 1],
       [1, 1, 0, 0, 0, 0, 0, 0, 1, 1, 1, 1, 1, 0, 5, 0, 1, 1, 1],
       [1, 1, 1, 1, 1, 0, 0, 0, 1, 1, 1, 1, 1, 0, 5, 0, 1, 1, 1],
       [1, 1, 1, 1, 1, 0, 0, 0, 1, 1, 1, 1, 1, 0, 5, 0, 1, 1, 1],
       [1, 1, 0, 0, 0, 0, 0, 0, 1, 1, 1, 1, 1, 0, 5, 0, 1, 1, 1],
       [1, 1, 0, 0, 0, 0, 0, 0, 1, 1, 1, 1, 1, 0, 5, 0, 1, 1, 1],
       [1, 1, 0, 0, 0, 1, 1, 1, 1, 1, 1, 1, 1, 0, 5, 0, 1, 1, 1],
       [1, 1, 0, 0, 0, 1, 1, 1, 1, 1, 1, 1, 1, 0, 5, 0, 1, 1, 1],
       [1, 1, 0, 0, 0, 0, 0, 1, 1, 1, 1, 1, 0, 0, 0, 0, 0, 1, 1],
       [1, 1, 0, 0, 0, 0, 0, 0, 0, 0, 1, 1, 0, 0, 0, 0, 0, 1, 1],
       [1, 1, 0, 0, 0, 0, 0, 0, 0, 0, 0, 0, 0, 0, 0, 0, 0, 1, 1],
       [1, 1, 0, 0, 0, 0, 0, 0, 0, 0, 0, 0, 0, 0, 0, 0, 0, 1, 1],
       [1, 1, 0, 0, 0, 0, 0, 0, 0, 0, 0, 0, 0, 0, 0, 0, 0, 1, 1],
       [1, 1, 0, 0, 0, 0, 0, 0, 0, 0, 1, 1, 0, 0, 0, 0, 0, 1, 1],
       [1, 1, 0, 0, 0, 0, 0, 1, 1, 1, 1, 1, 0, 0, 0, 0, 0, 1, 1],
       [1, 1, 1, 1, 1, 1, 1, 1, 1, 1, 1, 1, 1, 1, 1, 1, 1, 1, 1],
       [1, 1, 1, 1, 1, 1, 1, 1, 1, 1, 1, 1, 1, 1, 1, 1, 1, 1, 1]],
    "enemies":[
      {
        "radius": 180,
        "fov": 120,
        "omega": 40,
        "keypoints": [[2, 21, 0], [2, 21, 120], [2, 21, 240]]
      }, 
      {
        "radius": 180,
        "fov": 100,
        "keypoints": [[6, 14], [3, 14]]
      },
      {
        "radius": 180,
        "fov": 100,
        "keypoints": [[3, 9], [6, 9]]
      },
      {
        "radius": 100,
        "fov": 90,
        "keypoints": [[7, 2], [7, 4]]
      },
      {
        "radius": 100,
        "fov": 90,
        "keypoints": [[9, 4], [9, 2]]
      },
      {
        "radius": 100,
        "fov": 90,
        "keypoints": [[11, 2], [11, 4]]
      },
      {
        "radius": 180,
        "fov": 90,
        "omega": 0,
        "keypoints": [[13, 7]]
      },
      {
        "radius": 180,
        "fov": 90,
        "omega": 0,
        "keypoints": [[15, 9, 180]]
      },
      {
        "radius": 180,
        "fov": 90,
        "omega": 0,
        "keypoints": [[13, 11]]
      },
      {
        "radius": 180,
        "fov": 90,
        "omega": 0,
        "keypoints": [[15, 13, 180]]
      },
      {
        "radius": 180,
        "fov": 90,
        "omega": 0,
        "keypoints": [[13, 15]]
      },
      {
        "radius": 180,
        "fov": 90,
        "omega": 0,
        "keypoints": [[15, 17, 180]]
      },
      {
        "radius": 180,
        "fov": 90,
        "omega": 0,
        "keypoints": [[13, 19]]
      }
    ]
}
