{
    "playerX": 5,
    "playerY": 12,
    "map":
      [[1,1,1,1,1,1,1,1,1,1,1,1,1,1,1,1,1,1,1,1,1,1,1,1,0,0,0,0],
      [1,0,0,0,0,0,0,0,0,1,1,1,1,1,1,1,1,1,1,1,1,0,0,1,0,0,0,0],
      [1,0,0,0,0,0,0,0,0,1,1,1,1,1,1,1,1,1,1,0,0,0,0,1,1,1,1,1],
      [1,0,0,0,0,0,0,0,0,1,1,0,1,1,1,1,1,0,0,0,0,0,0,1,0,0,1,1],
      [1,0,0,0,0,0,0,0,0,1,1,0,1,1,1,0,0,0,0,0,0,0,0,1,0,0,0,1],
      [1,0,0,0,0,0,0,0,0,2,2,2,2,2,2,0,0,0,0,0,0,0,0,1,0,0,0,1],
      [1,0,0,0,4,4,4,0,0,0,0,0,0,0,3,0,0,0,0,0,0,0,0,0,0,0,1,1],
      [1,0,0,0,1,0,1,0,0,4,4,4,4,4,3,0,0,0,0,0,0,0,0,0,0,0,1,1],
      [1,0,0,0,1,0,1,1,1,1,1,1,1,1,1,1,1,1,1,1,1,1,1,1,1,1,1,1],
      [1,0,0,0,1,0,1,0,0,0,0,0,0,0,0,0,0,0,0,0,0,0,0,0,0,0,0,0],
      [1,0,0,0,1,1,1,0,0,0,0,0,0,0,0,0,0,0,0,0,0,0,0,0,0,0,0,0],
      [1,0,0,0,0,0,1,0,0,0,0,0,0,0,0,0,0,0,0,0,0,0,0,0,0,0,0,0],
      [1,0,0,0,0,0,1,0,0,0,0,0,0,0,0,0,0,0,0,0,0,0,0,0,0,0,0,0],
      [1,0,0,0,0,0,1,0,0,0,0,0,0,0,0,0,0,0,0,0,0,0,0,0,0,0,0,0],
      [1,1,1,1,1,1,1,0,0,0,0,0,0,0,0,0,0,0,0,0,0,0,0,0,0,0,0,0]],
    "enemies":[
      {
        "radius": 300,
        "fov": 120,
        "omega": 10,
        "keypoints": [[3, 8, 0], [3, 8, 240], [3, 8, 120]]
      },
      {
        "radius": 300,
        "fov": 120,
        "omega": 0,
        "keypoints": [[11, 3, 90]]
      },
      {
        "radius": 300,
        "fov": 120,
        "omega": 5,
        "keypoints": [[16, 4, 0], [16, 4, 240], [16, 4, 120]]
      },
      {
        "radius": 300,
        "fov": 120,
        "omega": 5,
        "keypoints": [[18, 3, 60], [18, 3, 300], [18, 3, 180]]
      },
      {
        "radius": 300,
        "fov": 120,
        "omega": 5,
        "keypoints": [[20, 2, 120], [20, 2, 0], [20, 2, 240]]
      },
      {
        "radius": 300,
        "fov": 120,
        "omega": -5,
        "keypoints": [[22, 1, 180], [22, 1, 60], [22, 1, 300]]
      }
    ]
}
