{
    "playerX": 16,
    "playerY": 6,
    "map":
     [[1,0,1,1,1,1,1,1,1,1,1,1,1,1,1,1,1,1,1,1,1,1,1,1,1,0,0,0,0],
      [1,0,0,0,0,0,1,0,0,0,1,1,1,1,1,1,1,1,1,1,1,1,1,1,1,0,0,0,0],
      [1,0,0,0,0,1,1,1,0,0,1,1,1,1,1,1,1,1,1,1,1,1,1,1,1,1,1,1,1],
      [1,0,0,0,0,1,1,1,0,0,1,1,1,1,1,1,1,1,1,1,1,1,1,1,1,0,0,1,1],
      [1,0,0,0,0,4,4,4,0,0,1,1,0,1,1,1,0,0,0,0,0,0,0,0,1,0,0,0,1],
      [1,0,0,0,0,0,0,0,0,0,2,2,2,2,2,2,0,0,0,0,0,0,0,0,1,0,0,0,1],
      [1,0,0,0,0,0,0,0,0,0,0,0,0,0,0,3,0,0,0,0,0,0,0,0,0,0,0,1,1],
      [1,0,0,0,0,1,0,1,0,0,4,4,4,4,4,3,0,0,0,0,0,0,0,0,0,0,0,1,1],
      [1,0,0,0,0,1,0,1,1,1,1,1,1,1,1,1,1,1,1,1,1,1,1,1,1,1,1,1,1],
      [1,0,0,0,0,1,1,1,0,0,0,0,0,0,0,0,0,0,0,0,0,0,0,0,0,0,0,0,0],
      [1,0,0,0,0,1,1,1,0,0,0,0,0,0,0,0,0,0,0,0,0,0,0,0,0,0,0,0,0],
      [1,0,0,0,0,0,0,1,0,0,0,0,0,0,0,0,0,0,0,0,0,0,0,0,0,0,0,0,0],
      [1,0,0,0,0,0,0,1,0,0,0,0,0,0,0,0,0,0,0,0,0,0,0,0,0,0,0,0,0],
      [1,0,0,0,0,0,0,1,0,0,0,0,0,0,0,0,0,0,0,0,0,0,0,0,0,0,0,0,0],
      [1,1,1,1,1,1,1,1,0,0,0,0,0,0,0,0,0,0,0,0,0,0,0,0,0,0,0,0,0]],
    "enemies":[
      {
        "radius": 270,
        "fov": 120,
        "omega": 8,
        "keypoints": [[4, 10, 0], [4, 10, 240], [4, 10, 120]]
      },
      {
        "radius": 270,
        "fov": 120,
        "omega": 0,
        "keypoints": [[6, 8, 270]]
      },
      {
        "radius": 270,
        "fov": 120,
        "omega": 0,
        "keypoints": [[12, 4, 90]]
      },
      {
        "radius": 270,
        "fov": 120,
        "omega": 5,
        "keypoints": [[17, 4, 180], [17, 4, 60], [17, 4, 300]]
      },
      {
        "radius": 270,
        "fov": 120,
        "omega": 5,
        "keypoints": [[20, 4, 120], [20, 4, 0], [20, 4, 240]]
      },
      {
        "radius": 270,
        "fov": 120,
        "omega": 5,
        "keypoints": [[23, 4, 60], [23, 4, 300], [23, 4, 180]]
      }
    ]
}
