{
    "playerX": 6,
    "playerY": 11,
    "gunX": 6,
    "gunY": 13,
    "map":
     [[1,1,1,1,1,1,1,1,1,1,1,1,1,1,1,1,1,1,1,1,1,1,1,1,1,1,1,1,1,1,1,1,1],
      [1,0,0,0,0,0,1,0,0,0,1,1,1,1,1,1,1,1,1,1,1,1,1,1,1,1,1,1,1,1,1,1,1],
      [1,0,0,0,0,1,1,1,0,0,1,1,1,1,1,1,1,1,1,1,1,1,1,1,1,1,1,1,1,1,1,1,1],
      [1,0,0,0,1,1,1,1,1,0,1,1,0,1,1,1,1,1,1,1,1,1,1,1,1,1,1,1,1,0,0,1,1],
      [1,0,0,0,4,4,4,4,4,0,1,1,0,1,1,1,1,1,0,0,0,0,0,0,0,0,0,0,1,0,9,0,1],
      [1,0,0,0,0,0,0,0,0,0,2,2,2,2,2,2,0,1,0,0,0,0,0,0,0,0,0,0,1,0,0,0,1],
      [1,0,0,0,0,0,0,0,0,0,0,0,0,0,0,3,0,0,0,0,0,0,0,0,0,0,0,0,0,0,0,1,1],
    [1,0,0,10,11,1,0,1,0,0,4,4,4,4,4,3,0,0,0,0,0,0,0,0,0,0,0,0,0,0,0,1,1],
      [1,0,0,0,0,1,0,1,1,1,1,1,1,1,1,1,1,1,1,1,1,1,1,1,1,1,1,1,1,1,1,1,1],
      [1,0,0,0,0,1,1,1,0,0,0,0,0,0,0,0,0,0,0,0,0,0,0,0,0,0,0,0,0,0,0,0,0],
      [1,0,0,0,0,1,1,1,0,0,0,0,0,0,0,0,0,0,0,0,0,0,0,0,0,0,0,0,0,0,0,0,0],
      [1,0,0,0,0,0,0,1,0,0,0,0,0,0,0,0,0,0,0,0,0,0,0,0,0,0,0,0,0,0,0,0,0],
      [1,0,0,0,0,0,0,1,0,0,0,0,0,0,0,0,0,0,0,0,0,0,0,0,0,0,0,0,0,0,0,0,0],
      [1,0,0,0,0,0,0,1,0,0,0,0,0,0,0,0,0,0,0,0,0,0,0,0,0,0,0,0,0,0,0,0,0],
      [1,1,1,1,1,1,1,1,0,0,0,0,0,0,0,0,0,0,0,0,0,0,0,0,0,0,0,0,0,0,0,0,0]],
    "enemies":[
      {
        "radius": 270,
        "fov": 120,
        "omega": 6,
        "keypoints": [[4, 10, 0]]
      },
      {
        "radius": 270,
        "fov": 120,
        "omega": 0,
        "keypoints": [[6, 8, 270]]
      },
      {
        "radius": 270,
        "fov": 120,
        "omega": 0,
        "keypoints": [[12, 3, 90]]
      },
      {
        "radius": 270,
        "fov": 120,
        "omega": -4,
        "keypoints": [[18, 4, 0]]
      },
      {
        "radius": 270,
        "fov": 120,
        "omega": -4,
        "keypoints": [[22, 4, 180]]
      },
      {
        "radius": 270,
        "fov": 120,
        "omega": -4,
        "keypoints": [[26, 4, 0]]
      }
    ]
}
