{
    "playerX": 9,
    "playerY": 9,
    "map":
      [[4,4,4,4,4,4,4,4,5,4,4,4,4,4,4,4,4,5],
      [3,5,2,2,2,2,2,2,5,3,5,2,2,2,2,2,2,5],
      [3,5,4,4,4,4,5,3,5,3,5,4,4,4,4,5,3,5],
      [3,5,3,5,2,2,5,3,5,3,5,3,5,2,2,5,3,5],
      [3,5,3,5,4,3,5,3,5,3,5,3,4,5,3,5,3,5],
      [3,5,3,5,3,2,2,3,5,3,5,3,2,2,3,5,3,5],
      [3,5,3,4,4,4,4,3,5,3,4,4,4,4,3,5,3,5],
      [3,5,3,2,2,2,2,2,2,3,2,2,2,2,2,2,3,5],
      [3,4,4,4,4,4,4,4,4,4,4,4,4,4,4,4,3,5],
      [3,5,2,2,2,2,2,2,2,2,2,2,2,2,2,2,2,5],
      [3,5,4,4,4,4,4,4,5,4,4,4,4,4,4,5,3,5],
      [3,5,3,5,2,2,2,2,5,3,2,2,2,2,2,5,3,5],
      [3,5,3,5,4,4,5,3,5,3,5,4,4,5,3,5,3,5],
      [3,5,3,5,3,2,5,3,5,3,5,3,5,2,3,5,3,5],
      [3,5,3,4,4,3,5,3,5,3,5,3,4,4,3,5,3,5],
      [3,5,3,2,2,2,2,3,5,3,5,3,2,2,2,2,3,5],
      [3,4,4,4,4,4,4,3,5,3,4,4,4,4,4,4,3,5],
      [3,2,2,2,2,2,2,2,2,3,2,2,2,2,2,2,2,2]],
    "enemies":[]
}
