{
    "playerX": 7,
    "playerY": 7,
    "map":
     [[1,1,1,1,1,1,1,1,1,1,1,1,1,1,1,1],
      [1,4,4,4,4,4,4,5,4,4,4,4,4,4,5,1],
      [1,3,5,2,2,2,2,5,3,5,2,2,2,2,5,1],
      [1,3,5,4,4,5,3,5,3,5,4,4,5,3,5,1],
      [1,3,5,3,5,2,3,5,3,5,3,2,5,3,5,1],
      [1,3,5,3,4,4,3,5,3,4,4,3,5,3,5,1],
      [1,3,5,3,2,2,2,2,3,2,2,2,2,3,5,1],
      [1,3,4,4,4,4,4,4,4,4,4,4,4,3,5,1],
      [1,3,5,2,2,2,2,2,2,2,2,2,2,2,5,1],
      [1,3,5,4,4,4,4,5,4,4,4,4,5,3,5,1],
      [1,3,5,3,5,2,2,5,3,5,2,2,5,3,5,1],
      [1,3,5,3,4,5,3,5,3,5,4,3,5,3,5,1],
      [1,3,5,3,2,2,3,5,3,5,3,2,2,3,5,1],
      [1,3,4,4,4,4,3,5,3,4,4,4,4,3,5,1],
      [1,3,2,2,2,2,2,2,3,2,2,2,2,2,2,1],
      [1,1,1,1,1,1,1,1,1,1,1,1,1,1,1,1]],
    "enemies":[]
}
