{
    "playerX": 3,
    "playerY": 3,
    "map":
      [[1, 1, 1, 1, 1, 1, 1, 1, 1],
       [1, 1, 1, 1, 1, 1, 1, 1, 1],
       [1, 1, 1, 1, 1, 1, 1, 1, 1],
       [1, 1, 1, 0, 0, 0, 1, 1, 1],
       [1, 1, 1, 0, 0, 0, 1, 1, 1],
       [1, 1, 1, 0, 0, 0, 1, 1, 1],
       [1, 1, 1, 1, 1, 1, 1, 1, 1],
       [1, 1, 1, 1, 1, 1, 1, 1, 1],
       [1, 1, 1, 1, 1, 1, 1, 1, 1]]
}
